****************
*             E*
*  *** ***** ***
*    *      *  *
**** *    **   *
*    ** ***    *
*        *     *
*            ***
*  *******     *
*          *****
***** ****   ***
*        **    *
*S           * *
****************
