****************
*             E*
* *********  ***
*    *    *    *
**** *    *    *
*    ******    *
*S             *
****************
